********************
*     *     *     L*
* *** *** ***** ****
* *   *            *
* * ***** * ***** **
*     *   *     *  *
***** * ******* ****
*       *     *    *
* *** * ***** ******
********************
