******************************
*     *     *       *      L *
* *** *** ***** ***** **** * *
* *   *   *   *     *    *   *
* * ***** * *** *** ** ***   *
*     *         *            *
***** * ******* ***** **** * *
*   * * *     *     *    *   *
* * * * * *** ***** **** * * *
*         * *     *    * *   *
* ******* * ***** * ** * **  *
*       *     *   *  * *     *
* ***** ***** * ***** *** *  *
*     *     *   *     *      *
******************************
